#########################################
#I  #   #   # #   #   #     #   # #     #
# ##### # ### # # ### ### ### ### ### # #
# #         # # #         #   #     # # #
# ##### ##### # ### ##### # ### ### # ###
#         #   #   # # # # # #   #       #
# ### # ### # ####### # # # ### #########
# #   #   # #       # # #     # #     # #
### ##### # # ####### # # # ### # ### # #
#   # #     #     # #   # # # #   #   # #
### # # ### # ##### ### # ### # # # # # #
# # #     # #         #     # # # # #   #
# # ##### # ############# ### ##### ### #
#     #   # # # # #   #   #         # # #
# ##### ##### # # # ### # ### # ### # # #
#     #             # # #     # #   #   #
### # ####### ### # # # # ### ##### # ###
#   # #     #   # # #   # #     # # # # #
# ######### # # ### # ### ### ### ##### #
#   #     #   #   #   # #   # #   # # # #
# ### # ##### ####### # ##### # ### # # #
# #   #   # #       # # #   # # # #     #
# # ####### # ####### # ### ### # ##### #
# # #   #   #     # # #   #     #       #
### # # # # # ##### # # # # ### # ### ###
#   # # # # #       # # #   #   #   #   #
# ### # # ####### # ##### ##### # ##### #
#   # # #         # #   # # #         # #
# ### ### # # ### ##### # # ### ### # # #
#   #     # #   # #           # # # # # #
# # # ### # # # # # ### ####### # ##### #
# #     # # # # # # #   #     # # #   # #
##### ############# # ### # ##### # # ###
#                 # # #   #   #     #   #
### ### ####### ### # # ##### ### # #####
# # #   #         # #   #     #   # #   #
# ##### ### ##### # # ### # ### ### ### #
#       # # #   #   # # # #     # #     #
# # # # # # ### # ### # ####### # # #####
# # # # #       # #   #         #    F  #
#########################################